1111111111111111111111111
10C0000C00000000CCCCCCC01
10C0000C00000000000000C01
10C0000C00000000000000C01
10C0000C000P0000000000C01
10CCCCCC00000000CCCCCCC01
1000000C00000000C00000001
1000000C00000000C00000001
1000000C000E0000CCCCCCC01
1111111111111111111111111